....................
....................
....................
..P.................
..####..............
....................
...........E........
.........#####......
....................
....................
...C.....E....C.....
####################
####################