....................
....................
............C.......
...........###......
....................
......E.............
.....###............
...C................
....................
.###................
.P..................
####################