####################
#..................#
#..C...######...C..#
#......#....#......#
#..P...#.E..#......#
#.###..######......#
#......#...........#
#..######..######..#
#..#....E..#....#..#
#..#.......#....#..#
#..###########..#..#
####################