....................
....................
....................
..P.................
..####..............
....................
...........E........
.........#####......
....................
....................
...C.E.E..E....C.....
####################
####################