....................
....................
...C.......E.......C
..###.....###....###
....................
.......E............
......####..........
...C................
..####..............
.P..................
####################
####################