....................
....................
....................
....................
..P.......C.........
.####...####........
....................
....................
......E.............
....####............
....................
####################